NO ./textures/theme_02/east.png
SO ./textures/theme_02/north.png
WE ./textures/theme_02/south.png        
EA ./textures/theme_02/west.png

F 255,76,76
C 255,76,76


1111
1N01
11






