NO ./textures/theme_02/east.png
SO ./textures/theme_02/north.png
WE ./textures/theme_02/south.png        
EA ./textures/theme_02/west.png

F 152,251,152
C 152,251,152


11111
10S01
11111

0






