NO 																																	./textures/theme_02/east.png




SO ./textures/theme_02/north.png
WE ./textures/theme_02/south.png        




EA ./textures/theme_02/west.png

F 111,111,111



C 155,100,160





1111111
1111111
11 1111
11 1111
11 1111
11N1111
1111111
