
NO ./textures/theme_02/east.png
SO ./textures/theme_02/north.png
WE ./textures/theme_02/south.png        
EA ./textures/theme_02/west.png

F 111,111,111
C 155,100,160

11111111111111111
10000000000000001
10100000100000101
10000000000000001
10001000100010001
10000000N00000001
10101010001010101
10000000000000001
10001000100100001
10000000000000001
10100000100001001
10000000000000001
01111111111111111
